9 9 9 9 9 9 9 9 9 9 9 H H H H H H H H H H H H H H H H H H H H 0
9 3 3 3 9 9 3 9 9 9 9 H H I I I I I I I I I I I I I I I I H H 0
9 3 0 0 0 0 0 3 3 9 9 H H 9 9 9 9 9 9 9 9 9 9 9 9 9 9 9 9 H H 0
9 9 0 0 0 0 0 0 3 3 9 H H 9 D E E D E E E E E E E E E D 9 H H 0
9 9 9 3 3 3 3 3 3 3 9 H H 9 D Q R D P P P D 6 6 6 6 6 D 9 H H 0
9 9 9 9 9 9 3 3 3 3 3 H H 0 D 6 N D 6 6 6 D 6 6 O O 6 D 0 H H 0
9 D E E E E E D D D 3 H H 0 D 6 O D P P 6 E 6 6 N N 6 D 0 H H 0
9 D P P P P P D D D 3 H H 0 D 6 6 E 6 6 6 6 6 6 O O 6 D 0 H H 0
9 D 6 6 6 6 6 D D D 3 H H 0 D 6 6 6 6 6 6 6 6 6 6 6 6 D 0 H H 0
9 D N O 6 6 6 D D D 3 H H 0 E E E E E E E E E 6 E E E E 0 H H 0
9 D 6 6 6 6 6 D M D 3 H H 0 0 0 0 0 0 0 0 0 0 6 0 0 0 0 0 H H 0
9 E E E E N E E E E 3 H H H H H H H H H H H H 6 H H H H H H H 0
9 9 3 3 0 6 0 3 3 3 3 I I I I I I I I I I I I 6 I I I I I I I 0
6 6 6 6 6 6 6 6 6 6 6 6 6 6 6 6 6 6 6 6 6 6 6 6 6 6 6 6 6 6 6 6
6 6 6 6 6 6 6 6 6 6 6 6 6 6 6 6 6 6 6 6 6 6 6 6 6 6 6 6 6 6 6 6
0 0 0 0 9 9 3 9 9 0 0 0 9 0 0 0 6 6 6 0 0 0 0 0 0 0 3 3 3 0 0 0
0 0 9 9 9 C C C 3 9 9 9 9 0 9 0 6 6 6 0 0 0 0 0 3 3 9 9 9 9 9 9
0 0 9 9 C C C C C C C C 3 0 0 0 6 6 6 0 3 3 3 3 3 3 9 9 9 9 9 9
0 9 9 C C C C C C C C C C 9 0 0 6 6 6 0 9 9 9 9 9 9 9 9 9 9 9 9
0 9 9 C C 3 C C C C C C C 9 0 0 6 6 6 0 9 9 9 9 9 9 9 9 9 9 9 9
9 9 9 9 9 9 9 9 9 9 C C C 9 0 0 6 6 6 0 9 D D D D D D D D D D 9
9 9 9 9 9 0 9 9 0 9 9 C 9 0 0 0 6 6 6 0 0 E E E E E E E E D D 9
9 D D E E E D D 0 0 0 3 0 0 0 0 6 6 6 6 6 6 6 6 6 6 6 N 6 D D 9
9 D E P P P E D 0 0 0 0 0 0 0 3 6 6 6 0 D D D 6 6 6 6 N 6 D D 9
9 D 6 6 6 6 6 D 0 0 0 0 0 0 3 3 6 6 6 0 D L D 6 6 6 6 N 6 D D 9
9 D 6 6 6 O 6 E E E 0 0 0 3 3 3 6 6 6 0 E D E E E 6 E E E D D 9
9 D 6 6 N 6 6 6 6 6 6 6 6 6 6 6 6 6 6 0 9 D Q R 6 6 6 Q R D D 9
9 D 6 O 6 6 6 E E D 0 0 0 0 3 3 6 6 6 9 9 D Q R 6 6 6 Q R D D 9
9 D 6 6 6 6 6 6 6 D 3 0 0 0 0 3 6 6 6 9 9 D Q R 6 6 6 Q R D D 9
9 D 6 6 6 6 6 6 6 D 3 0 0 0 0 3 6 6 6 9 9 D D D D D D D D D D 9
9 E E E E E E E E E 3 3 0 0 0 0 6 6 6 3 9 D D D D D D D D D D 9
9 9 9 9 9 9 9 9 9 9 9 9 3 0 0 0 6 6 6 3 9 9 9 9 9 9 9 9 9 9 9 9
